R 800 400
NO ./texture/WALL53.xpm
SO ./texture/WALL47.xpm
WE ./texture/WALL76.xpm
EA    ./texture/WALL89.xpm
S ./texture/1.xpm
F 26, 43, 58
C 34,  53, 43

        1111111111111111111111111
        1000000000110000000000001
        1000000001110000002000001
        1001000000000000000000001
111111111011000001110000000000001
100000000011000001110111111111111
11110111111111011100000010001
11110111111111011101010010001
11000000110101011100000010001
10002222222000000000000000001
1000000000220W001101010010001
1100200111010101111101111000111
11110111 1110101 101111010001
11111111 1111111 111111111111
